Ts'o'ok k tàal Pisté.	We finished arriving [in] Pisté.',
Ko'ox Goyo. Ko'ox máan te' k'iiwike.	' Let's go Goyo. Let's go go-about the plaza.',
Ko'ox túun. Uts tin wich le chan káah P'isté.	' Let's go then. I like this little town of P'isté.',
Ileh. Táan u konik ba'al te'elo.	' Look! They are selling things there.',
Eeh. Ba'ax táan u koniko'ob?	' Eeh. What are they selling?',
Táak a manik he wah ba'axe'?	' Do you want to buy something?',
Haah. Tàak in màan. tàak in manik hunp'éel ba'al.	' “Yes”. I want to shop. I want to buy a [“one”] thing.',
Ko'otene'ex waye. Tu'ux ka máane'ex?	' Come over here you-all! Where are you-all going about?',
Chen táan k máan way P'iste'a'.	' We are just strolling about Pisté-here.',
Aaah, táan a chan máane'ex way P'iste'a'.	' Aaah, You-all are walking around a little “here in P'iste.”',
Tu'ux ka tàale'ex?	' Where are you-all “coming from”?',
K tàal Tusik. Tusik k hach káahalo'on.	' We come from Tusik. Tusik is our true hometown.',
Ba'ax ka konik xunan?	' What do you sell woman?',
Tene' kin konik k'áan.	' As for me, I sell hammocks.',
Aaah, ka konik k'áan. K'abeet in manik hunp'éel k'áan.	' Aaah, you sell hammocks. I need to buy a hammock.',
Òokene'ex. Òokene'ex a wile'ex ba'ax yàan a manike'ex.	' Enter! Enter you-all to see what you-all will buy.',
Ba'ax k'abeete'ex? Ba'ax uts ta wiche'ex?	' What do you-all need? What do you-all like?',
Kux teech, Goyo? K'abeet a manik k'áan?	' And you Goyo? Do you need to buy a hammock?',
Ma'atech. Ma'a k'abeet in maniki'. Ts'o'ok in manik ho'olheak.	' “Nope.” I do not need to buy one. I finished buying one yesterday.',
Ma'alob túun. Teeche' máak, ba'ax tàak a manik? Ba'ax tàak a bisik?	' Good then. As for you “dude”, what do you want to buy? What do you want to take [with you]?'
Tene' tàak in manik hunp'éel nohoch k'áan.	' As for me, I want to buy a big hammock.',
Yàan ten nohoch k'áan. Yàan ten nohoch yéetel k'an k'áano'ob.	' I have big hammocks. I have big and yellow hammocks.',
Yàan a hóok'sik utial k iliko'ob?	' Will you take them out so that we can see them?',
Yàan, yàan in hóok'siko'ob.	' “Will-do”, I will take them out.',
Máakelmáak uts ta wich? K'abéet a ch'a'ik.	' Which one do you like? You “should” take it.',
Lelo uts tin wich. Tàak in bisik lelo.	' That one is good to my eyes. I want to take that one.',
Ma'alob kin ts'áahik tech le k'áano.	' Good. I give you that hammock.',
Ts'áah ten le k'áana'. Tàak in bisik tin nahil.	' Give me this hammock. I want to take it [with me] to my home.',
Beyo', ts'o'ok a manik wah?	' Like that you finished buying it?',
Bey ts'o'ok in manika', k'abéet k hóok'ol be'òorah.	' Like this I finished buying it, we should leave now.'